{
    "0": {
        "name": "Beginner Level",
        "data": [
            "##########",
            "#   t    #",
            "#        #",
            "#  b  b  #",
            "#        #",
            "#   p    #",
            "#  b  t  #",
            "#        #",
            "#   t    #",
            "##########"
        ],
        "created_by": "admin",
        "date": "2025-05-29"
    },
    "1": {
        "name": "ali",
        "data": [
            " ########",
            " #    t #",
            " # b p  #",
            " #      #",
            " #  b t #",
            " #      #",
            " ########",
            "   t"
        ],
        "created_by": "admin",
        "date": "2025-05-29"
    },
    "2": {
        "name": "test",
        "data": [
            "##############",
            "#            #",
            "#    p  b    #",
            "#  b         #",
            "#          b #",
            "#t          t#",
            "#            #",
            "#     b      #",
            "#            #",
            "#            #",
            "# t        t #",
            "##############"
        ],
        "created_by": "admin",
        "date": "2025-05-29"
    }
}